10 11 11 11 11 11 11 11 11 11 11 11 11 11 11 12
13 14 14 14 14 14 14 14 14 14 14 14 14 14 14 16
13 14 14 14 14 14 14 14 14 14 14 14 14 14 14 16
13 14 14 14 14 14 14 14 14 14 14 14 14 14 14 16
13 14 14 14 14 14 14 14 14 14 14 14 14 14 14 16
13 14 14 14 14 14 14 14 14 14 14 14 14 14 14 16
13 14 14 14 14 14 14 14 14 14 14 14 14 14 14 16
13 14 14 14 14 14 14 14 14 14 14 14 14 14 14 16
13 14 14 14 14 14 14 14 14 14 14 14 14 14 14 16
13 14 14 14 14 14 14 14 14 14 14 14 14 14 14 16
13 14 14 14 14 14 14 14 14 14 14 14 14 14 14 16
17 18 18 18 18 18 18 18 18 18 18 18 18 18 18 19