10 10 10 10 10 10 10 10 10 10 10 10 10 10 10 10 10 10 10 10 10 10 10 10 10 10 10 10 10 10 10 10 10 10 10 10 10 10 10 10 10 10 10 10 10 10 10 10 10 10
10 10 10 10 10 10 10 10 10 10 10 10 10 10 10 10 10 10 10 10 10 10 10 10 10 10 10 10 10 10 10 10 10 10 10 10 10 10 10 10 10 10 10 10 10 10 10 10 10 10
10 10 10 10 10 10 10 10 10 10 19 20 20 20 20 20 20 20 20 20 20 20 20 20 20 20 20 20 20 20 20 20 20 20 20 20 20 20 20 20 20 20 20 21 10 10 10 10 10 10
10 10 10 10 10 10 10 10 10 10 22 13 13 13 13 13 13 13 13 13 13 13 13 13 13 13 13 13 13 13 13 13 13 13 13 13 13 13 13 13 13 13 13 23 10 10 10 10 10 10
10 10 10 10 10 10 10 10 10 10 22 13 13 13 13 13 13 13 13 13 13 13 13 13 13 13 13 13 13 13 13 13 13 13 13 13 13 13 13 13 13 13 13 23 10 10 10 10 10 10
10 10 10 10 10 10 10 10 10 10 22 13 13 13 13 13 13 13 13 13 13 13 13 13 13 13 13 13 13 13 13 13 13 13 13 13 13 13 13 13 13 13 13 23 10 10 10 10 10 10
10 10 10 10 10 10 10 10 10 10 22 13 13 13 13 13 13 13 13 13 13 13 13 13 13 13 13 13 13 13 13 13 13 13 13 13 13 13 13 13 13 13 13 23 10 10 10 10 10 10
20 20 20 20 20 20 20 20 20 20 27 13 13 13 13 13 13 13 13 13 13 13 11 11 11 11 11 11 13 13 13 13 13 13 13 13 13 13 13 13 13 13 13 23 10 10 10 10 10 10
13 13 13 13 13 13 13 13 13 13 13 13 13 13 13 13 13 13 13 13 13 13 11 11 11 11 11 11 13 13 13 13 13 13 13 13 13 13 13 13 13 13 13 23 10 10 10 10 10 10
13 13 13 13 13 13 13 13 13 13 13 13 13 13 13 13 13 13 13 13 13 13 11 11 11 11 11 11 13 13 13 13 13 13 13 13 13 13 13 13 13 13 13 23 10 10 10 10 10 10
13 13 13 13 13 13 13 13 13 13 13 13 13 13 13 13 13 13 13 13 13 13 11 11 11 11 11 11 13 13 13 13 13 13 13 13 13 13 13 13 13 13 13 23 10 10 10 10 10 10
13 13 13 13 11 13 13 13 13 13 13 13 13 13 13 13 13 13 13 13 13 13 11 11 11 11 11 11 13 13 13 13 13 13 13 13 13 13 13 13 11 13 13 23 10 10 10 10 10 10
13 13 13 13 11 11 11 11 11 11 13 13 13 13 13 13 13 13 13 13 13 13 13 13 13 11 13 13 13 13 13 13 13 13 13 13 13 13 13 13 11 13 13 28 20 20 20 20 20 20
13 13 13 13 13 13 13 13 13 11 13 13 13 13 13 13 13 13 13 13 13 13 13 13 13 11 13 13 13 13 13 13 13 13 13 13 13 13 13 13 11 13 13 13 13 13 13 13 13 13
13 13 13 13 13 13 13 13 13 11 13 13 13 13 13 13 13 13 13 13 13 13 13 13 13 11 11 11 11 13 13 13 13 13 13 13 13 13 13 13 11 13 13 13 13 13 13 13 13 13
13 13 13 13 13 13 13 13 13 11 13 13 13 13 13 13 13 13 13 13 13 13 13 13 13 11 13 13 11 11 11 11 13 13 13 13 13 13 13 13 11 13 13 13 13 13 13 13 13 13
13 13 13 13 13 13 13 13 13 11 13 13 13 13 13 13 13 13 13 13 13 13 13 13 11 11 13 13 13 13 13 11 13 13 13 13 13 13 13 13 11 13 13 13 13 13 13 13 13 13
16 16 16 16 16 16 16 16 16 11 13 13 13 13 13 13 13 13 13 13 13 13 13 13 11 13 13 13 13 13 13 11 13 13 13 13 13 13 13 13 11 13 13 13 13 13 13 13 13 13
16 16 16 16 16 16 16 16 16 11 13 13 13 13 13 13 11 11 11 11 11 11 11 11 11 13 13 13 13 13 13 11 11 11 11 11 11 11 11 11 11 13 13 13 13 13 13 13 13 13
16 16 16 16 16 16 16 16 16 11 13 13 13 13 13 13 11 11 11 11 11 11 11 11 11 13 13 13 13 13 13 13 13 13 13 13 13 13 13 13 11 13 13 13 13 13 30 25 25 25
16 16 16 16 16 16 16 16 16 11 13 13 13 13 13 13 11 11 11 11 11 11 11 11 11 13 13 13 13 13 13 13 13 13 13 13 13 13 13 13 11 13 13 13 13 13 23 10 10 10
16 16 16 16 16 16 16 16 16 11 13 13 13 13 13 13 11 11 11 11 11 11 11 11 11 13 13 13 13 13 13 13 13 13 13 13 13 13 13 13 11 13 13 13 13 13 23 10 10 10
16 16 16 16 16 16 16 16 16 11 13 13 13 13 13 13 11 11 11 11 11 11 11 11 11 13 13 13 13 13 13 13 13 13 13 13 13 13 13 13 11 13 13 13 13 13 23 10 10 10
16 16 16 16 16 16 16 16 16 11 13 13 13 13 13 13 11 11 11 11 11 11 11 11 11 13 13 13 13 13 13 13 13 13 13 13 13 13 13 13 11 13 13 13 13 13 23 10 10 10
16 16 16 16 16 16 16 16 16 11 13 13 13 13 13 13 13 13 13 11 11 11 11 11 11 13 13 13 13 13 13 13 13 13 13 13 13 13 13 13 11 11 13 13 13 13 23 10 10 10
13 11 11 11 11 11 11 11 11 11 13 13 13 13 13 13 13 13 13 11 11 11 11 11 11 13 13 13 13 13 13 13 13 13 13 13 13 13 13 13 13 11 13 13 13 30 26 10 10 10
13 11 13 13 13 13 13 13 13 13 13 13 13 13 13 13 13 13 13 11 11 11 11 11 11 13 13 13 13 13 13 13 13 13 13 13 13 13 13 13 13 11 13 13 13 23 10 10 10 10
11 11 13 13 13 13 13 13 13 13 13 13 13 13 13 13 13 13 13 13 13 13 13 13 11 13 13 13 13 13 13 13 13 13 13 13 13 13 13 13 13 11 11 11 13 23 10 10 10 10
11 13 30 25 25 25 25 25 25 25 25 29 13 13 13 13 13 13 13 13 13 13 13 13 11 13 13 13 13 13 13 13 13 13 13 13 13 13 13 13 13 13 13 11 13 28 21 10 10 10
11 13 23 10 10 10 10 10 10 10 10 22 13 13 13 13 13 13 13 13 13 13 13 13 11 11 11 13 13 13 13 13 13 13 13 13 13 13 13 13 13 13 13 11 13 13 23 10 10 10
11 13 23 10 10 10 10 10 10 10 10 22 13 13 13 13 13 13 13 13 13 13 13 13 13 13 11 13 13 13 13 13 13 13 13 13 13 13 13 13 13 13 13 11 13 13 28 20 21 10
11 13 23 10 10 10 10 10 19 20 20 27 13 13 13 13 13 13 13 13 13 13 13 13 13 13 11 13 13 13 13 13 13 13 13 13 13 13 13 13 13 13 13 11 13 13 13 13 23 10
11 13 23 10 10 10 10 10 22 13 13 13 13 13 13 13 13 13 13 13 13 13 13 13 13 13 11 13 13 13 13 13 13 13 13 13 13 13 13 13 13 13 13 11 13 13 13 13 23 10
11 13 23 10 10 10 10 10 22 13 13 13 13 13 13 13 13 13 13 13 13 13 13 13 13 13 11 13 13 13 13 13 13 13 13 13 13 13 13 13 13 13 13 11 13 13 13 13 23 10
11 13 23 10 10 10 10 10 22 13 13 13 13 13 13 13 13 13 13 13 13 13 13 13 13 13 11 13 13 13 13 13 13 13 13 13 13 13 13 13 13 13 13 11 13 13 13 13 23 10
11 13 23 10 10 10 10 19 27 13 13 13 13 13 13 13 13 13 13 13 13 13 13 13 13 13 11 13 13 13 13 13 13 13 13 13 13 13 13 13 13 13 13 11 13 13 13 13 23 10
11 13 28 21 10 10 10 22 13 13 13 13 13 13 13 13 13 13 13 13 13 13 13 13 13 13 11 13 13 13 13 13 13 13 13 13 13 13 13 13 13 13 13 11 13 13 13 13 23 10
11 13 15 28 20 20 20 27 13 13 13 13 13 13 13 13 13 13 13 13 13 13 13 13 13 13 11 13 13 13 13 13 13 13 13 13 13 13 11 11 11 11 11 11 13 13 13 13 23 10
11 13 13 13 13 13 13 13 13 13 13 13 13 13 13 13 13 13 13 13 13 13 13 13 13 13 11 13 13 13 13 13 13 13 13 13 13 13 11 13 13 13 13 13 13 13 13 13 23 10
11 11 11 11 11 11 11 11 11 11 11 11 11 11 11 13 13 13 13 13 13 13 13 13 13 13 11 13 13 13 13 13 13 13 13 13 13 13 11 13 13 13 13 13 13 13 13 13 23 10
13 13 13 13 13 13 13 13 13 13 13 13 13 13 11 13 13 13 13 13 13 13 13 13 13 13 11 13 11 13 13 13 13 13 13 13 13 13 11 13 13 13 13 13 13 13 13 13 23 10
13 13 13 13 13 13 13 13 13 13 13 13 13 13 11 11 13 13 13 13 11 11 11 11 11 11 11 11 11 13 13 13 13 13 13 11 11 11 11 13 13 13 13 13 13 13 13 13 23 10
13 13 13 13 13 13 13 13 13 13 13 13 13 13 13 11 13 13 13 13 11 11 11 11 11 11 11 11 11 11 11 11 11 11 11 11 13 13 11 13 13 13 13 13 13 13 13 13 23 10
13 13 13 13 13 13 13 13 13 13 13 13 13 13 13 11 11 11 11 11 11 11 11 11 11 11 11 11 11 13 13 13 13 13 13 13 13 13 11 13 13 13 13 13 13 13 13 13 23 10
13 13 13 13 13 13 13 13 13 13 13 13 13 13 13 13 13 13 13 13 13 13 13 13 13 13 13 13 13 13 13 13 13 13 13 13 13 13 11 13 13 30 25 25 25 25 25 25 26 10
13 13 13 13 13 13 13 13 13 13 13 13 13 13 13 30 25 25 25 25 25 25 25 25 25 25 25 25 25 25 25 25 29 13 13 13 13 13 11 13 13 23 10 10 10 10 10 10 10 10
13 13 13 13 13 13 13 13 13 13 13 30 25 25 25 26 10 10 10 10 10 10 10 10 10 10 10 10 10 10 10 10 22 13 13 13 13 13 11 13 13 23 10 10 10 10 10 10 10 10
13 13 13 13 13 13 13 13 13 13 13 23 10 10 10 10 10 10 10 10 10 10 10 10 10 10 10 10 10 10 10 10 22 13 13 13 13 11 11 11 13 23 10 10 10 10 10 10 10 10
25 25 25 25 25 25 25 25 25 25 25 26 10 10 10 10 10 10 10 10 10 10 10 10 10 10 10 10 10 10 10 10 22 13 13 13 13 11 11 11 13 23 10 10 10 10 10 10 10 10
10 10 10 10 10 10 10 10 10 10 10 10 10 10 10 10 10 10 10 10 10 10 10 10 10 10 10 10 10 10 10 10 22 13 13 13 13 13 13 13 13 23 10 10 10 10 10 10 10 10