10 10 10 10 10 10 10 10 10 10 10 10 10 10 10 10 10 10 10 10 10 10 10 10 10 10 10 10 10 10 10 10 10 10 10 10 10 10 10 10 10 10 10 10 10 10 10 10 10 10 10 10 10 10 10 10 10 10 10 10
10 10 10 10 10 10 10 10 10 10 10 10 10 10 10 10 10 10 10 10 10 10 10 10 10 10 10 10 10 10 10 10 10 10 10 10 10 10 10 10 10 10 10 10 10 10 10 10 10 10 10 10 10 10 10 10 10 10 10 10
10 10 10 10 10 10 10 10 10 10 10 10 10 10 10 10 10 10 10 10 10 10 10 10 10 10 10 10 10 10 10 10 10 10 10 10 10 10 10 10 10 10 10 10 10 10 10 10 10 10 10 10 10 10 10 10 10 10 10 10
10 10 10 10 10 10 10 10 10 10 10 10 10 10 10 10 10 10 10 10 10 10 10 10 10 10 10 10 10 10 10 10 10 10 10 10 10 10 10 10 10 10 10 10 10 10 10 10 10 10 10 10 10 10 10 10 10 10 10 10
10 10 10 10 10 10 10 10 10 10 10 10 10 10 10 10 10 10 10 10 10 10 10 10 10 10 10 10 10 10 10 10 10 10 10 10 10 10 10 10 10 10 10 10 10 10 10 10 10 10 10 10 10 10 10 10 10 10 10 10
10 10 10 10 10 10 10 10 10 10 10 10 10 10 10 10 10 10 10 10 10 10 10 10 10 10 10 10 10 10 10 10 10 10 10 10 10 10 10 10 10 10 10 10 10 10 10 10 10 10 10 10 10 10 10 10 10 10 10 10
10 10 10 10 10 10 10 10 10 10 10 10 10 10 10 10 10 10 10 10 10 10 10 10 10 10 10 10 10 10 10 10 10 10 10 10 10 10 10 10 10 10 10 10 10 10 10 10 10 10 10 10 10 10 10 10 10 10 10 10
10 10 10 10 10 10 10 19 20 20 20 20 20 20 20 20 20 20 20 20 20 20 20 20 20 20 20 20 20 20 20 20 20 20 20 20 20 20 20 20 20 20 20 20 20 20 20 20 20 20 20 20 21 10 10 10 10 10 10 10
10 10 10 10 10 10 10 22 13 13 13 13 13 13 13 13 13 13 13 13 13 13 13 13 13 13 13 13 13 13 13 13 13 13 13 13 13 13 13 13 13 13 13 13 13 13 13 13 13 13 13 13 23 10 10 10 10 10 10 10
10 10 10 10 10 10 10 22 13 13 13 13 13 13 13 13 13 13 13 13 13 13 13 13 13 13 13 13 13 13 13 13 13 13 13 13 13 13 13 13 13 13 13 13 13 13 13 13 13 13 13 13 23 10 10 10 10 10 10 10
10 10 10 10 10 10 10 22 13 13 13 13 13 13 13 13 13 13 13 13 13 13 13 13 13 11 11 11 11 11 13 13 13 13 13 13 13 13 13 13 13 13 13 13 13 13 13 13 13 13 13 13 23 10 10 10 10 10 10 10
10 10 10 10 10 10 10 22 13 13 13 13 13 13 13 13 13 13 13 13 13 13 13 13 13 11 11 11 11 11 11 11 11 13 13 13 13 13 13 13 13 13 13 13 13 12 13 13 13 13 13 13 23 10 10 10 10 10 10 10
10 10 10 10 10 10 10 22 13 13 13 13 13 13 13 13 13 13 13 13 13 13 13 13 13 11 11 11 11 11 13 13 12 13 13 13 13 13 13 13 13 13 13 13 13 12 13 13 13 13 13 13 23 10 10 10 10 10 10 10
10 10 10 10 10 10 10 22 13 13 13 13 13 13 13 13 13 13 13 13 13 13 13 13 13 11 11 11 11 11 13 13 12 11 11 13 13 13 13 13 13 12 11 11 11 11 11 11 11 13 13 13 23 10 10 10 10 10 10 10
10 10 10 10 10 10 10 22 13 13 13 13 13 13 13 13 13 13 13 13 13 13 13 13 13 13 13 13 12 13 13 13 13 13 12 13 13 13 13 13 13 12 13 13 13 13 13 13 12 11 13 13 23 10 10 10 10 10 10 10
10 10 10 10 10 10 10 22 13 13 13 13 13 13 13 13 13 13 13 13 13 13 13 13 13 13 13 13 12 13 13 13 13 13 12 11 11 11 11 11 11 11 13 13 13 13 13 13 13 12 13 13 23 10 10 10 10 10 10 10
10 10 10 10 10 10 10 22 13 13 13 13 13 13 13 13 13 13 13 13 13 13 13 13 13 13 13 13 12 13 13 13 13 13 13 13 13 13 13 13 13 13 13 13 13 13 13 13 13 12 13 13 23 10 10 10 10 10 10 10
10 10 10 10 10 10 10 22 13 13 13 13 13 13 13 13 13 13 13 13 13 13 13 13 13 13 13 13 12 13 13 13 13 13 30 25 25 25 25 25 29 13 13 13 13 13 13 13 13 12 13 13 23 10 10 10 10 10 10 10
10 10 10 10 10 10 10 22 13 13 13 13 13 13 13 13 13 13 13 13 13 13 13 13 13 13 13 13 12 13 13 13 13 13 23 10 10 10 10 10 22 13 13 13 13 13 13 13 13 12 13 13 23 10 10 10 10 10 10 10
10 10 10 10 10 10 10 22 13 13 13 13 13 13 13 13 13 13 13 13 13 13 13 13 13 13 13 13 13 13 13 13 13 13 23 10 10 10 10 10 22 13 13 13 13 13 13 13 13 12 13 13 23 10 10 10 10 10 10 10
10 10 10 10 10 10 10 22 13 13 13 13 13 13 13 13 13 13 13 13 13 13 13 13 13 13 13 13 13 13 13 13 13 13 23 10 10 10 10 10 22 13 13 13 13 13 13 13 13 12 13 13 23 10 10 10 10 10 10 10
10 10 10 10 10 10 10 22 13 13 13 13 13 13 13 13 13 13 13 13 13 13 13 13 13 13 13 13 13 13 13 13 13 13 23 10 10 10 10 10 24 25 29 13 13 13 13 13 13 12 13 13 23 10 10 10 10 10 10 10
10 10 10 10 10 10 10 22 13 13 13 13 13 13 13 13 13 13 13 13 13 13 13 13 13 13 13 13 13 13 13 13 13 13 23 10 10 10 10 10 10 10 22 13 13 13 13 13 13 12 13 13 23 10 10 10 10 10 10 10
10 10 10 10 10 10 10 22 13 13 13 13 13 13 13 13 13 13 13 13 13 13 13 13 13 13 13 13 13 13 13 13 13 13 23 10 10 10 10 10 10 10 22 13 13 13 11 11 11 12 13 13 23 10 10 10 10 10 10 10
10 10 10 10 10 10 10 22 13 13 13 13 13 13 13 13 13 13 13 13 13 13 13 13 12 12 12 12 12 12 12 13 13 13 28 20 20 20 20 20 20 20 27 13 13 13 12 13 13 13 13 13 23 10 10 10 10 10 10 10
10 10 10 10 10 10 10 22 13 13 13 13 13 13 13 13 13 13 13 13 13 13 13 13 12 12 12 12 12 12 12 13 13 13 13 13 13 13 13 13 13 13 13 13 13 13 12 13 13 13 13 13 23 10 10 10 10 10 10 10
10 10 10 10 10 10 10 22 13 13 13 13 13 13 13 13 13 13 13 13 13 13 13 13 12 12 12 12 12 12 12 13 13 13 13 13 13 13 13 13 13 13 13 13 13 13 12 13 13 13 13 13 23 10 10 10 10 10 10 10
10 10 10 10 10 10 10 22 13 13 13 13 13 13 13 13 13 13 13 13 13 13 13 13 12 12 12 12 12 12 12 11 11 11 11 11 11 11 11 11 11 11 11 11 11 11 12 13 13 13 13 13 23 10 10 10 10 10 10 10
10 10 10 10 10 10 10 22 13 13 13 13 13 13 13 13 13 13 13 13 13 13 13 13 12 12 12 12 12 12 12 13 13 13 13 13 13 13 13 13 13 13 13 13 13 13 12 13 13 13 13 13 23 10 10 10 10 10 10 10
10 10 10 10 10 10 10 22 13 13 13 13 13 13 13 13 13 13 13 13 13 13 13 13 12 12 12 12 12 12 12 13 13 13 13 13 13 13 13 13 13 13 13 13 13 13 12 13 13 13 13 13 23 10 10 10 10 10 10 10
10 10 10 10 10 10 10 22 13 13 13 13 13 13 13 13 13 13 13 13 13 13 13 13 13 13 13 12 13 13 13 13 13 13 13 13 13 13 13 13 13 13 13 13 13 13 12 13 13 13 13 13 23 10 10 10 10 10 10 10
10 10 10 10 10 10 10 22 13 13 13 13 13 13 13 13 13 13 13 13 13 13 13 13 13 13 13 12 13 13 13 13 13 13 13 13 13 13 13 13 13 13 13 13 13 13 12 13 13 13 13 13 23 10 10 10 10 10 10 10
10 10 10 10 10 10 10 22 13 13 13 13 13 13 13 13 13 13 13 13 13 13 13 13 13 13 13 12 13 13 13 13 13 13 13 13 13 13 13 13 13 13 13 13 13 13 12 13 13 13 13 13 23 10 10 10 10 10 10 10
10 10 10 10 10 10 10 22 13 13 13 13 13 13 13 13 13 13 13 13 13 13 13 13 13 13 13 12 13 13 13 13 13 13 13 13 13 13 13 13 13 13 13 13 13 13 12 13 13 13 13 13 23 10 10 10 10 10 10 10
10 10 10 10 10 10 10 22 13 13 13 13 13 13 13 13 13 13 13 13 13 13 13 13 13 13 13 12 13 13 13 13 13 13 13 13 13 13 13 13 13 13 13 13 13 13 12 13 13 13 13 13 23 10 10 10 10 10 10 10
10 10 10 10 10 10 10 22 13 13 13 13 13 13 13 13 13 13 13 13 13 13 13 13 13 13 13 12 13 13 13 13 13 13 13 13 13 13 13 13 13 13 13 13 13 13 12 13 13 13 13 13 23 10 10 10 10 10 10 10
10 10 10 10 10 10 10 22 13 13 13 13 13 13 13 13 13 13 13 13 13 13 13 13 13 13 13 11 11 11 12 13 13 13 13 13 13 13 13 13 13 13 13 13 13 13 12 13 13 13 13 13 23 10 10 10 10 10 10 10
10 10 10 10 10 10 10 22 13 13 13 13 13 13 13 13 13 13 13 13 13 13 13 13 13 13 13 13 13 13 12 13 13 13 13 13 13 13 12 11 11 11 11 11 11 11 12 13 13 13 13 13 23 10 10 10 10 10 10 10
10 10 10 10 10 10 10 22 13 13 13 13 13 30 25 25 25 25 25 25 25 25 25 25 25 25 29 13 13 13 12 13 13 13 13 13 13 13 12 13 13 13 13 13 13 13 12 13 13 13 13 13 23 10 10 10 10 10 10 10
10 10 10 10 10 10 10 22 13 13 13 13 13 23 10 10 10 10 10 10 10 10 10 10 10 10 22 13 13 13 12 11 12 11 11 11 11 11 11 13 13 13 13 13 13 13 12 13 13 13 13 13 23 10 10 10 10 10 10 10
10 10 10 10 10 10 10 22 13 13 13 13 13 23 10 10 10 10 10 10 10 10 10 10 10 10 22 13 13 13 13 13 12 13 13 13 13 13 13 13 13 13 13 13 13 13 12 13 13 13 13 13 23 10 10 10 10 10 10 10
10 10 10 10 10 10 10 22 13 13 13 13 13 23 10 10 10 10 10 10 10 10 10 10 10 10 22 13 13 13 13 13 12 13 13 13 13 13 13 13 13 13 13 13 13 13 12 13 13 13 13 13 23 10 10 10 10 10 10 10
10 10 10 10 10 10 10 22 13 13 13 13 13 23 10 10 10 10 10 10 10 10 10 10 10 10 22 13 13 13 13 13 12 13 13 13 13 13 13 13 13 13 13 13 13 13 12 13 13 13 13 13 23 10 10 10 10 10 10 10
10 10 10 10 10 10 10 22 13 13 13 13 13 23 10 10 10 10 10 10 10 10 10 10 10 10 22 13 13 13 13 13 12 13 13 13 13 13 13 13 13 13 13 13 13 13 12 11 11 12 13 13 23 10 10 10 10 10 10 10
10 10 10 10 10 10 10 22 13 13 13 13 13 28 21 10 10 10 10 10 10 10 10 10 10 10 22 13 13 13 13 13 12 13 13 13 13 13 13 13 13 13 13 13 13 13 13 13 13 11 13 13 23 10 10 10 10 10 10 10
10 10 10 10 10 10 10 22 13 13 13 13 13 13 23 10 10 10 10 10 10 10 10 10 10 10 22 13 13 13 13 13 12 13 13 13 13 13 13 13 13 13 13 13 13 13 13 13 13 11 13 13 23 10 10 10 10 10 10 10
10 10 10 10 10 10 10 22 13 13 13 13 13 13 28 20 20 20 21 10 10 10 10 10 10 10 22 13 13 13 13 13 12 13 13 13 13 13 13 13 13 13 13 13 13 13 13 13 13 11 13 13 23 10 10 10 10 10 10 10
10 10 10 10 10 10 10 22 13 13 13 13 13 13 13 13 13 13 23 10 10 10 10 10 10 10 22 13 13 13 13 13 12 13 13 13 13 13 13 13 13 11 13 13 13 13 13 13 13 12 13 13 23 10 10 10 10 10 10 10
10 10 10 10 10 10 10 22 13 13 13 13 13 13 13 13 13 13 28 20 20 20 20 20 20 20 27 13 13 13 13 13 12 13 13 13 13 13 13 13 13 11 11 11 11 11 13 13 13 12 13 13 23 10 10 10 10 10 10 10
10 10 10 10 10 10 10 22 13 13 13 13 13 13 13 13 13 13 13 13 13 13 13 13 13 13 13 13 12 11 11 11 11 13 13 13 13 13 13 13 13 13 13 13 13 11 13 13 13 12 13 13 23 10 10 10 10 10 10 10
10 10 10 10 10 10 10 22 13 13 13 13 13 13 13 13 13 13 13 13 13 13 11 11 11 11 11 11 11 13 13 13 13 13 13 13 13 13 13 13 13 13 13 13 13 11 11 11 11 12 13 13 23 10 10 10 10 10 10 10
10 10 10 10 10 10 10 22 13 13 13 13 13 13 13 13 13 13 13 13 13 13 13 13 13 13 13 13 13 13 13 13 13 13 13 13 13 13 13 13 13 13 13 13 13 13 13 13 13 13 13 13 23 10 10 10 10 10 10 10
10 10 10 10 10 10 10 22 13 13 13 13 13 13 13 13 13 13 13 13 13 13 13 13 13 13 13 13 13 13 13 13 13 13 13 13 13 13 13 13 13 13 13 13 13 13 13 13 13 13 13 13 23 10 10 10 10 10 10 10
10 10 10 10 10 10 10 24 25 25 25 25 25 25 25 25 25 25 25 25 25 25 25 25 25 25 25 25 25 25 25 25 25 25 25 25 25 25 25 25 25 25 25 25 25 25 25 25 25 25 25 25 26 10 10 10 10 10 10 10
10 10 10 10 10 10 10 10 10 10 10 10 10 10 10 10 10 10 10 10 10 10 10 10 10 10 10 10 10 10 10 10 10 10 10 10 10 10 10 10 10 10 10 10 10 10 10 10 10 10 10 10 10 10 10 10 10 10 10 10
10 10 10 10 10 10 10 10 10 10 10 10 10 10 10 10 10 10 10 10 10 10 10 10 10 10 10 10 10 10 10 10 10 10 10 10 10 10 10 10 10 10 10 10 10 10 10 10 10 10 10 10 10 10 10 10 10 10 10 10
10 10 10 10 10 10 10 10 10 10 10 10 10 10 10 10 10 10 10 10 10 10 10 10 10 10 10 10 10 10 10 10 10 10 10 10 10 10 10 10 10 10 10 10 10 10 10 10 10 10 10 10 10 10 10 10 10 10 10 10
10 10 10 10 10 10 10 10 10 10 10 10 10 10 10 10 10 10 10 10 10 10 10 10 10 10 10 10 10 10 10 10 10 10 10 10 10 10 10 10 10 10 10 10 10 10 10 10 10 10 10 10 10 10 10 10 10 10 10 10
10 10 10 10 10 10 10 10 10 10 10 10 10 10 10 10 10 10 10 10 10 10 10 10 10 10 10 10 10 10 10 10 10 10 10 10 10 10 10 10 10 10 10 10 10 10 10 10 10 10 10 10 10 10 10 10 10 10 10 10
10 10 10 10 10 10 10 10 10 10 10 10 10 10 10 10 10 10 10 10 10 10 10 10 10 10 10 10 10 10 10 10 10 10 10 10 10 10 10 10 10 10 10 10 10 10 10 10 10 10 10 10 10 10 10 10 10 10 10 10
10 10 10 10 10 10 10 10 10 10 10 10 10 10 10 10 10 10 10 10 10 10 10 10 10 10 10 10 10 10 10 10 10 10 10 10 10 10 10 10 10 10 10 10 10 10 10 10 10 10 10 10 10 10 10 10 10 10 10 10











